AEROEMBOLUS	DiagnosisOrProblem
AIRWAY	Anatomy
AORTOGRAM	Test
AORTOILIAC	Anatomy-Desc
BACILLI	Organism
BACTERIURIA	SymptomOrSign
BALLANTYNE	DiagnosisOrProblem
BANDS	Device|Anatomy-Desc|Histology
BANTI	DiagnosisOrProblem
BARLOW	DiagnosisOrProblem|Test
BARTONELLOSIS	DiagnosisOrProblem
BASOPHILISM	DiagnosisOrProblem
BAYLEY	Test
BEDSORE	DiagnosisOrProblem
BELCHINGS	BodyFunction
BELOW	Locative
BESNIER	DiagnosisOrProblem
BICEPS	Anatomy
BICIPITAL	Anatomy-Adj
BIFURCATION	Locative|Anatomy-Desc
BILARY	Anatomy
BILIRUBINEMIAS	DiagnosisOrProblem
BINOCULAR	Anatomy-Desc
BIOMETRY	Test
BIPOLAR	DiagnosisOrProblem
BITINGS	Causes|DiagnosisOrProblem
BORIC	Biochemistry
BOTULISM	DiagnosisOrProblem
CAISSON	DiagnosisOrProblem
CALCIFICATIONS	DiagnosisOrProblem|GrowthOrForeignBody
CALF	Anatomy
CALICEAL	Anatomy-Adj
CALYCOPLASTY	TreatmentOrProcedure
CANALS	Anatomy-Desc
CANCERS	DiagnosisOrProblem|GrowthOrForeignBody
CANNULA	Device
CAPILLARIA	Organism
CAPSULIT	DiagnosisOrProblem
CARBN	PharmacyOrDrug
CARBUNCLES	DiagnosisOrProblem
CARDIO	Anatomy
CARDIOASSIST	TreatmentOrProcedure
CARDIOMEDIASTINAL	Anatomy-Desc
CARDIOPATHY	DiagnosisOrProblem
CARDIOVERSION	TreatmentOrProcedure
CARINATUM	Anatomy-Desc
CARNOSINURIA	SymptomOrSign
CARTILAGINOUS	Anatomy-Desc
CATARCT	DiagnosisOrProblem
CATHETER	Device
CATHETERIZATION	TreatmentOrProcedure
CATHS	DEVICE|TREATMENTORPROCEDURE
CAVA	Anatomy|Anatomy-Desc
CAVAL	Anatomy-Adj|Anatomy-Desc
CAVERNOSOGRAM	Test
CECIL	TreatmentOrProcedure
CELOSOMIA	DiagnosisOrProblem
CENTIMETER	Measure
CENTRILOBULAR	Anatomy-Desc
CEPHALOSPORIN	PharmacyOrDrug
CEREBELLUM	Anatomy
CEREBRAL	Anatomy-Adj
CEREBROVASCULAR	Anatomy-Desc
CERVICECTOMY	TreatmentOrProcedure
CERVICOTHORACIC	Anatomy-Desc
CESTODES	Organism
CINERADIOGRAPHY	Test
CISTERNOGRAM	Test
COAGULATION	Test
COCCI	Organism
COCCYGODYNIA	SymptomOrSign
COCHLEAR	Anatomy-Adj
COLDS	DiagnosisOrProblem
COLLAPSING	DiagnosisOrProblem
COLLECTION	DIAGNOSISORPROBLEM
COLONOSCOPY	Test
COLPOCELE	DiagnosisOrProblem
COLUMNS	Anatomy-Desc
COMBUSTION	Biochemistry
COMPLICATIONS	DiagnosisOrProblem
CONCUSSIONS	DiagnosisOrProblem
CONES	Anatomy
CONJUNCTIVA	Anatomy
CONSCIOUSNESS	SymptomOrSign
CONSTITUT	Anatomy-Desc
CONTRACEPTIVE	PharmacyOrDrug
CONTUSIONS	DiagnosisOrProblem
COPROPHILIA	DiagnosisOrProblem
CORDS	Anatomy
CORNEOSCLERAL	Anatomy-Desc
CORNS	DiagnosisOrProblem
CORRIGAN	SymptomOrSign
CORTICOSPINAL	Anatomy-Desc
CORYNEBACTERIUM	Organism
COUMARIN	PharmacyOrDrug
COWBANE	PharmacyOrDrug
DACRYOCYSTOGRAPHY	Test
DAMUS	TreatmentOrProcedure
DATA	Measure
DAYS	Measure
DECALCIFICATION	TreatmentOrProcedure
DECORTICATION	TreatmentOrProcedure
DEFECTS	DiagnosisOrProblem
DEFORMATION	DiagnosisOrProblem
DEHYDRASE	Biochemistry
DELIRE	DiagnosisOrProblem
DEMENTIAS	DiagnosisOrProblem|SymptomOrSign
DEMINERALIZED	DIAGNOSISORPROBLEM
DENTICLES	GrowthOrForeignBody
DENTINAL	Anatomy-Adj
DEOXYCORTICOSTERONE	Biochemistry
DEPRESSED	SymptomOrSign
DERENCEPHALUS	DiagnosisOrProblem
DERMATITIS	DiagnosisOrProblem
DERMATOLYSIS	DiagnosisOrProblem
DERMATOPHYTOSIS	DiagnosisOrProblem
DERMOGRAPHISM	DiagnosisOrProblem
DESMOLASE	Biochemistry
DEVICE	Device
DEXTROTHYROXIN	PharmacyOrDrug
DIAPHORASE	Biochemistry
DIAPHYSIS	Anatomy-Desc
DIASTEMA	Anatomy
DICALCIUM	Biochemistry
DIELDRIN	Causes
DIGESTANT	PharmacyOrDrug
DIGITAL	Anatomy-Adj
DIHYDROPYRIMIDINE	Biochemistry
DILATOR	Device
DIOCTYL	Biochemistry|PharmacyOrDrug
DIPHENYLPYRALINE	PharmacyOrDrug
DIPHYLLOBOTHRIOSIS	DiagnosisOrProblem
DIPROSOPUS	DiagnosisOrProblem
DIROFILARIA	Organism
DISCISSION	TreatmentOrProcedure
DISK	Anatomy
DISLOCATIONS	DiagnosisOrProblem
DISPROPORTION	DiagnosisOrProblem
DISSEM	Anatomy-Adj|DiagnosisOrProblem
DISTENTION	SymptomOrSign
DISULFI	PharmacyOrDrug
DIVERTICULI	GrowthOrForeignBody
DIZZINESSES	SymptomOrSign
DIZZYNESS	SYMPTOMORSIGN
DIZZY	SYMPTOMORSIGN
DOPA	Biochemistry|PharmacyOrDrug
DOSAGE	Measure
DOXYCYCLINE	PharmacyOrDrug
EEG	Test
FACE	Anatomy
FACIAL	Anatomy-Adj
FAINTED	SymptomOrSign
FALCIFORME	Biochemistry|Anatomy-Adj
FANCONIS	DiagnosisOrProblem
FASCIOLIASES	DiagnosisOrProblem
FAUCES	Anatomy
FECES	BodyByProduct
FERMENTATIONS	Biochemistry
FETOR	SymptomOrSign
FIBRIN	Biochemistry
FIBROADENOMAS	DiagnosisOrProblem
FIBROEPITHELIAL	Anatomy-Desc
FIBROLIPOMA	DiagnosisOrProblem
FIBROMYOSITIS	DiagnosisOrProblem
FIBROSING	Histology
FILARIOIDEA	Organism
FINGER	Anatomy
FISTULAE	Anatomy|DiagnosisOrProblem
FOLATE	Biochemistry
FOOT	Anatomy
FORDYCE	DiagnosisOrProblem
FORMICATION	SymptomOrSign
GABAPENTIN	PharmacyOrDrug
GALACTORRHOEA	DiagnosisOrProblem
GALLSTONE	DiagnosisOrProblem|GrowthOrForeignBody
GANCICLOVIR	PharmacyOrDrug
GANGLIONITIS	DiagnosisOrProblem
GAS	Biochemistry
GASSER	Anatomy-Desc
GASTRO	Anatomy
GASTROENTEROSTOMY	TreatmentOrProcedure
GASTROJEJUNAL	Anatomy-Desc
GASTRORRHAPHY	TreatmentOrProcedure
GASTROSTOMY	TreatmentOrProcedure|Device
GENIT	Anatomy
GERM	Organism
GIARDIASIS	DiagnosisOrProblem
GINGIVA	Anatomy
GIRDLE	Anatomy-Desc
GOITER	DiagnosisOrProblem
GONIOPHOTOGRAPHY	Test
GOODPASTURE	DiagnosisOrProblem
HAEMOGLOBINOPATHY	DiagnosisOrProblem
HALITOSES	SymptomOrSign
HALLUCINOSIS	DiagnosisOrProblem
HAMSTRING	Anatomy
HAM	Test
HAPTOGLOBINS	Biochemistry
HAT	Biochemistry
HEADS	Anatomy
HEATSTROKE	DiagnosisOrProblem
HELIUM	Biochemistry
HEMAGGLUTININ	Biochemistry
HEMANGIOSARCOMA	GrowthOrForeignBody
HEMATOCOLPOMETRA	SymptomOrSign
HEMATOMYELIA	DiagnosisOrProblem
HEMATOXYLIN	Biochemistry
HEMIANOPSIA	DiagnosisOrProblem
HEMICONVULSION	SymptomOrSign
HEMIFACIAL	Anatomy-Desc
HEMIPARESES	DiagnosisOrProblem
HEMISPHERIC	Anatomy-Adj
HEMIVULVECTOMY	TreatmentOrProcedure
HEMOGLOBINOPATHIES	DiagnosisOrProblem
HEMOPERFUSION	TreatmentOrProcedure
HEMOQUANT	Biochemistry
HEMOSIDERIN	Biochemistry|Test
HEPATECTOMY	TreatmentOrProcedure
HEPATOGENOUS	Anatomy-Desc
HEPATOMAS	GrowthOrForeignBody
HERMAPHRODITISM	DiagnosisOrProblem
HERPES	DiagnosisOrProblem
HETEROPHYES	Organism
HEXOKINASE	Biochemistry
HICCOUGHS	SymptomOrSign
HIDROTIC	PharmacyOrDrug
HIRSUTIES	SymptomOrSign|DiagnosisOrProblem
HISTIO	Histology
HISTONE	Biochemistry
HOFFMANN	DiagnosisOrProblem
HOLTER	Device|Test
HOMOLATERAL	Locative
HORMONES	Biochemistry|PharmacyOrDrug
IATROGN	Anatomy-Desc
IODIDES	Biochemistry|PharmacyOrDrug
JANICEPS	DiagnosisOrProblem
JERKINGS	SymptomOrSign
KAOLINOSIS	DiagnosisOrProblem
KELOID	DiagnosisOrProblem|GrowthOrForeignBody
KEOFEED	DEVICE
KERATOACANTHOMAS	GrowthOrForeignBody
KERATOIDITIS	DiagnosisOrProblem
KERATOPLASTY	TreatmentOrProcedure
KETOACIDOSIS	DiagnosisOrProblem
KETOTHIOLASE	Biochemistry
KOBNER	DiagnosisOrProblem
LABRINTHOTOMY	TreatmentOrProcedure
LACRIMATION	BodyFunction
LACTOSE	Biochemistry
LACUNAR	Anatomy-Adj
LANGERHAN	Anatomy
LARINGOSCOPY	Test
LARYNGOFISSURE	Anatomy
LARYNGOSTENOSIS	DiagnosisOrProblem
LATISSIMUS	Anatomy-Desc
LAVAGE	TreatmentOrProcedure
LEFT	Locative
LEIOMYOFIBROMA	GrowthOrForeignBody
LENSES	Device
LEPTOCYTOSIS	DiagnosisOrProblem
LETHARGY	DiagnosisOrProblem|SymptomOrSign
LEUKAEMIA	DiagnosisOrProblem
LEUKOCYTOPENIA	DiagnosisOrProblem
LEUKOENCEPHALY	DiagnosisOrProblem
LEUKOPLAKIA	DiagnosisOrProblem
LEVEL	Measure
LEVIN	Device
LICHEN	DiagnosisOrProblem
LIDOCAINE	PharmacyOrDrug
LIFEPORT	DEVICE|DIAGNOSISORPROBLEM
LIGATURE	Device
LINEA	Anatomy-Desc
LINE	Device
LINGUAE	Anatomy
LIPOADENOMA	GrowthOrForeignBody
LIPOFUSCINOSIS	DiagnosisOrProblem
LIPOPROTEINS	Biochemistry
LISTERIA	Organism
LIVER	Anatomy
LOBOTOMY	TreatmentOrProcedure
LONELINESS	SymptomOrSign
LOUSE	Organism
LOW-BACK	Anatomy-Desc
MACROCEPHALUS	DiagnosisOrProblem|SymptomOrSign
MACROGENIA	DiagnosisOrProblem
MACROLIDE	PharmacyOrDrug
MACULA	DiagnosisOrProblem
MAGGOTS	Organism
MALAISE	DiagnosisOrProblem|SymptomOrSign
MALFUNCTIONS	DiagnosisOrProblem
MALLEOLUS	Anatomy
MALOCCLUSION	DiagnosisOrProblem
MALUM	DiagnosisOrProblem
MANDIBLE	Anatomy
MANNOSIDASE	Biochemistry
MARBURG	DiagnosisOrProblem
MARSUPIALIZATION	TreatmentOrProcedure
MASSETERIC	Anatomy-Adj
MASTECTOMIES	TreatmentOrProcedure
MASTOIDITIS	DiagnosisOrProblem
MASTURBATION	DiagnosisOrProblem
MAXWELL	Measure
MECKEL	DiagnosisOrProblem|Anatomy
MEDIATEDNEPHRITIS	DiagnosisOrProblem
MEGACALYCOSIS	DiagnosisOrProblem
MEGALODUODENUM	DiagnosisOrProblem
MELANCHOLIA	DiagnosisOrProblem
MELANOGLOSSIA	DiagnosisOrProblem
MELENA	DiagnosisOrProblem
MEMBRANACEA	DiagnosisOrProblem
MENINGEONEPHALITIS	DiagnosisOrProblem
MENINGITIS	DiagnosisOrProblem
MENINGOENCEPHALOMYELITIS	DiagnosisOrProblem
MENINGOVASCULAR	Anatomy-Desc
MENISCUS	Anatomy
MENOSTAXIS	DiagnosisOrProblem
MEPHENYTION	PharmacyOrDrug
MEROMICROSOMIA	DiagnosisOrProblem
MESIODENS	Anatomy
MESODERMAL	Anatomy-Adj
METACARPAL	Anatomy
METANEPHRINES	PharmacyOrDrug
METAPHYSEAL	Anatomy-Adj
METAZOONOSIS	DiagnosisOrProblem
METHEMALBUMIN	Biochemistry
METHOHEXITAL	PharmacyOrDrug
METHYLMALONATE	Biochemistry
METYRAPONE	PharmacyOrDrug
MICROCEPHALIES	DiagnosisOrProblem
MICRODREPANOCYTOSIS	DiagnosisOrProblem
MICROGNATHISM	DiagnosisOrProblem
MICRONYCHIA	DiagnosisOrProblem
MICROPOLYGYRIA	DiagnosisOrProblem
MICROSPORUM	Organism
MID-BACK	Anatomy-Desc
MID	Locative
MIGRATION	Histology
MINERALIZATION	TreatmentOrProcedure
MISCARRIAGE	DiagnosisOrProblem
MOEBIUS	DiagnosisOrProblem|SymptomOrSign
MONGOLOIDISM	DiagnosisOrProblem
MONOARTHRITIS	DiagnosisOrProblem
MONOCHORIONIC	Anatomy-Desc
MONONEURITIS	DiagnosisOrProblem
MONOSOMY	DiagnosisOrProblem
MOORE	DiagnosisOrProblem
MORPHINE	PharmacyOrDrug
MOSCHKOWITZ	DiagnosisOrProblem
MOYAMOYA	DiagnosisOrProblem
NALORPHINE	PharmacyOrDrug
NARCISSISMS	DiagnosisOrProblem
NASOLARYNGOSCOPY	Test
NASO-PALATINE	Anatomy-Desc
NASOPANCREATIC	Anatomy-Desc
NEBULA	SymptomOrSign
NECK	Anatomy
NECROPSY	TreatmentOrProcedure
NEEDLE	Device
NEEDLEWIRE	Device
NEOP	GrowthOrForeignBody
NEOSTRIATAL	Anatomy-Desc
NEPHRECTOMY	TreatmentOrProcedure
NEPHROMA	GrowthOrForeignBody
NEPHROSCLEROSIS	DiagnosisOrProblem
NEPHROTOMY	TreatmentOrProcedure
NEURASTHENIA	DiagnosisOrProblem
NEURINOMA	GrowthOrForeignBody
NEURODERMATITIS	DiagnosisOrProblem
NEUROECTODERMAL	Anatomy-Desc
NEUROHYPOPHYSIS	Anatomy
NEUROMAS	GrowthOrForeignBody|DiagnosisOrProblem
NEUROPATHY	DiagnosisOrProblem
NEUROSTIMULATORS	Device
NEUROVISCERAL	Anatomy-Desc
NEUTROPENIAS	DiagnosisOrProblem
NICOTINAMIDE	Biochemistry
NINE	Measure
NITROBENZENE	PharmacyOrDrug
NOCARDIOSIS	DiagnosisOrProblem
NONANTIBODY	Biochemistry
NONCORONARY	Anatomy-Desc
NONPETROLEUM	PharmacyOrDrug
NONPIGMENTED	Anatomy-Desc
NORWALK	Biochemistry
NOTCHED	Anatomy-Desc
OESOPHAGOSPASM	DiagnosisOrProblem
OOPHORECTOMY	TreatmentOrProcedure
PACEMAKER	DEVICE|DIAGNOSISORPROBLEM
PACKS	Device
PALATES	Anatomy
PALMITOYLTRANSFERASE	Biochemistry
PALMOPLANTAR	Anatomy-Desc
PANARTERITIS	DiagnosisOrProblem
PANCREATOBLASTOMA	GrowthOrForeignBody
PANENCEPHALITIS	DiagnosisOrProblem
PANSINUSITIS	DiagnosisOrProblem
PAPILLARY	Anatomy-Adj
PAPILLITIS	DiagnosisOrProblem
PAPULES	SymptomOrSign
PARACUSIA	SymptomOrSign|DiagnosisOrProblem
PARAGONIMIASIS	DiagnosisOrProblem
PARALDEHYDE	PharmacyOrDrug
PARAMOLAR	Anatomy
PARANASAL	Anatomy-Desc
PARAPARESIS	SymptomOrSign|DiagnosisOrProblem
PARAPROTEINEMIAS	DiagnosisOrProblem
PARASPASM	DiagnosisOrProblem|SymptomOrSign
PARATHYROIDECTOMY	TreatmentOrProcedure
PARATRACHEAL	Anatomy-Adj
PARESES	DiagnosisOrProblem
PARIETOALVEOLAR	Anatomy-Desc
PAROTID	Anatomy
PAT	DiagnosisOrProblem
PECTENOSIS	DiagnosisOrProblem
PEDICULICIDE	PharmacyOrDrug
PEDUNCULATED	Anatomy-Adj
PELLAGRA	DiagnosisOrProblem
PEMPHIGOID	DiagnosisOrProblem
PENILE	Anatomy-Adj
PENTAMIDINE	Biochemistry
PEPTIDASE	Biochemistry
PERFORANS	Anatomy-Desc
PERFORATIONS	DiagnosisOrProblem
PERIBRONCHIAL	ANATOMY-ADJ
PERICARDIAL	Anatomy-Desc
PERICARDIOCENTESIS	TreatmentOrProcedure
PERICOLOSTOMY	TreatmentOrProcedure
PERIMOLYSIS	DiagnosisOrProblem
PERINEPHRIC	Anatomy-Adj
PERIODONTOSIS	DiagnosisOrProblem
PERIOSTOSIS	DiagnosisOrProblem
PERIPERAL	Anatomy-Desc
PERITHELIOMA	GrowthOrForeignBody
PERITUBAL	Anatomy-Desc
PERLECHE	DiagnosisOrProblem
PERONEUS	Anatomy-Desc
PERTUSSIS	DiagnosisOrProblem
PETHIDINE	PharmacyOrDrug
PIBLOKTO	DiagnosisOrProblem
PICC	DEVICE|DIAGNOSISORPROBLEM
PIGMENT	SymptomOrSign
PINEALOCYTOMAS	GrowthOrForeignBody|DiagnosisOrProblem
PINHOLE	Device
PIPERAZINE	PharmacyOrDrug
POEMS	DiagnosisOrProblem
POLARIZING	BodyFunction
POLE	Anatomy-Desc
POLLAKISURIA	DiagnosisOrProblem
POLYARTHROPATHIES	DiagnosisOrProblem
POLYDACTYLIAS	DiagnosisOrProblem
POLYGALACTIA	DiagnosisOrProblem
POLYMYALGIA	DiagnosisOrProblem
POLYOTIA	DiagnosisOrProblem
POLYRADICULITIS	DiagnosisOrProblem
POLYTOMOGRAPHY	Test
PONTO	Anatomy
POROSIS	BodyFunction
PORTOENTEROSTOMY	TreatmentOrProcedure
POSTAURICULAR	Anatomy-Adj
POSTCONCUSSION	DiagnosisOrProblem
POSTLACTATION	Anatomy-Desc
POSTMENOPAUSE	DiagnosisOrProblem
RACHISCHISIS	DiagnosisOrProblem
RADIOGRAPHY	Test
RADIOULN	Anatomy
RAMUS	Anatomy|Anatomy-Desc
RANITIDINE	PharmacyOrDrug
RATIO	Measure
REA	Test
RECEPTOR	Anatomy|Biochemistry
RECTORRHAGIA	DiagnosisOrProblem
RECTOURETHRAL	Anatomy-Adj
REDUCTASE	Biochemistry
REFLEXES	BodyFunction
REGION	Anatomy-Desc
REIMANN	DiagnosisOrProblem
REJECTION	DiagnosisOrProblem
RENAL	Anatomy-Desc
REPOSITION	TreatmentOrProcedure
RESET	TreatmentOrProcedure
RESTZUSTAND	DiagnosisOrProblem
RETICULOCYTE	Histology
RETICULOID	Anatomy-Desc
RETICULOSIS	DiagnosisOrProblem
RETINOCHOROIDITIS	DiagnosisOrProblem
RETROCOCHLEAR	Anatomy-Desc
RETROGNATHIA	DiagnosisOrProblem
RETROSTERNAL	Anatomy-Adj
RETTS	DiagnosisOrProblem
RICKETTSIA	Organism
RICKETTSIOSES	DIAGNOSISORPROBLEM
RIGHT	Locative
RIGOURS	DiagnosisOrProblem
ROENTGENOGRAPHY	Test
ROSEOLA	DiagnosisOrProblem
SACCADIC	BodyFunction
SACRAL	Anatomy-Adj
SACROILIITIS	DiagnosisOrProblem
SALINE	Biochemistry|PharmacyOrDrug
SALIVA	Anatomy
SALPINGECTOMY	TreatmentOrProcedure
SALPINGONEOSTOMY	TreatmentOrProcedure
SANDFLY	Organism
SAPHENOPOPLITEAL	Anatomy-Desc
SARCOIDOSIS	DiagnosisOrProblem
SARCOSPORIDIOSIS	DiagnosisOrProblem
SEBORRHIASIS	DiagnosisOrProblem
SEDATION	TreatmentOrProcedure
SEDATIVE	PharmacyOrDrug
SENILITY	DiagnosisOrProblem
SEMINIFEROUS	Anatomy-Desc
SEMINOMA	GrowthOrForeignBody
SENSITIZATION	Test
SEPSIS	DiagnosisOrProblem
SEPTAL	ANATOMY-ADJ
SEPTICEMIAS	DiagnosisOrProblem
SEQUOIOSIS	DiagnosisOrProblem
SEROSAL	Anatomy-Adj
SERUM	Anatomy
SIALADENITIS	DiagnosisOrProblem
SIALOCELE	DiagnosisOrProblem
SIALOSIS	DiagnosisOrProblem
SIGMATISM	SymptomOrSign
SILICOSIS	DiagnosisOrProblem
SINUS	Anatomy
SIRIASIS	DiagnosisOrProblem
SOB	DIAGNOSISORPROBLEM
SODOMY	SymptomOrSign
SOMATIC	Anatomy-Desc
SOMATOSENSORY	Test
SORETHROAT	SymptomOrSign|DiagnosisOrProblem
TACHYPNEA	SymptomOrSign|DiagnosisOrProblem
TAKAYASUS	DiagnosisOrProblem
TANTRUM	DiagnosisOrProblem
TARSAL	Anatomy-Adj
TARSORRHAPHY	TreatmentOrProcedure
TEETH	Anatomy
TEMAZEPAM	PharmacyOrDrug
TENDONITIS	DiagnosisOrProblem
TENOSYNOVITIS	DiagnosisOrProblem
TENTORIUM	Anatomy-Desc
TERES	Anatomy
TESTOSTERONE	Biochemistry
TETRACYCLINES	PharmacyOrDrug
TIAS	DiagnosisOrProblem
TIGHTNESS	SymptomOrSign
TIP	Locative
TITER	Measure
TOENAILS	Anatomy
TONGS	Device
TONSILS	Anatomy
TORSADES	DiagnosisOrProblem
TOX	Causes
TOXOCARA	Organism
VACCIN	PharmacyOrDrug
VACUUM	TreatmentOrProcedure
VAG	ANATOMY
VAGINAL	Anatomy-Adj
VALMID	PharmacyOrDrug
VALVULOPLASTY	TreatmentOrProcedure
VARICOSITIES	DiagnosisOrProblem
VASCULAR	Anatomy-Adj
VASCULAR-BILIARY	Anatomy-Desc
VASCULATURE	Anatomy
VASODILATORS	PharmacyOrDrug
VASOVASOSTOMY	TreatmentOrProcedure
VEIN	Anatomy
VEINS	Anatomy
VELO-CARDIO-FACIAL	Anatomy-Desc
VELPEAU	DiagnosisOrProblem
VENA	Anatomy-Desc
VENOGRAPHY	Test
VENOUS	Anatomy-Adj
VENTILATOR	Device
VENTRICULO-ATRIAL	Anatomy-Desc
VENTRICULONOGRAPHY	Test
VERRUCOSUM	GrowthOrForeignBody
VESICLE	DiagnosisOrProblem|SymptomOrSign
VESICOCOLIC	Anatomy-Adj
VESICULOGRAMS	Test
VESTIBULOCEREBELLAR	Anatomy-Desc
VIBRIO	Organism
VIRILISATION	DiagnosisOrProblem
VITAMIN	PharmacyOrDrug
VITREOUS	Anatomy-Adj
VOLKMANN	DiagnosisOrProblem|Anatomy
WAARDENBURG	DiagnosisOrProblem
WALL	Anatomy-Desc
WARTS	DiagnosisOrProblem
WAVE	Measure
WEBER	Measure
WERDNIG	DiagnosisOrProblem
WERLHOF	DiagnosisOrProblem
WILSON	DiagnosisOrProblem
WISDOM	Anatomy-Adj
WOOLEY	DiagnosisOrProblem
XANTHOFIBROMA	GrowthOrForeignBody
XERODERMA	DiagnosisOrProblem
XEROSTOMIAS	DiagnosisOrProblem
YERSINIOSIS	DiagnosisOrProblem